0,0,0,0,0,0,0,0,0,0,0,0,0,0,0,0,0,0,0,0
0,0,0,0,0,0,0,0,0,0,0,0,0,0,0,0,0,0,0,0
0,0,0,0,0,0,0,0,0,0,0,0,0,0,0,0,0,0,0,0
0,0,0,0,0,0,0,0,0,0,0,0,0,0,0,0,0,0,0,0
0,0,0,0,0,0,0,0,0,0,0,0,0,0,0,0,0,0,0,0
0,11,7,0,0,0,0,0,0,0,0,0,12,0,0,0,0,0,0,12
0,0,1,0,0,0,0,0,0,0,0,0,1,0,0,0,0,0,0,1
0,0,1,0,0,0,0,0,0,0,0,0,1,0,0,0,0,0,0,1
0,0,1,0,0,0,0,0,0,0,0,0,1,0,0,0,0,0,0,1
0,0,8,1,1,1,1,1,1,1,1,1,9,0,0,0,0,0,0,1
0,0,0,0,0,0,0,0,0,0,0,0,0,0,0,0,0,0,0,1
0,0,0,0,0,0,0,0,0,0,0,0,0,0,0,0,0,0,0,1
0,0,0,0,0,0,0,0,0,0,0,0,0,0,0,0,0,0,0,1
0,0,0,0,0,0,6,1,1,1,1,1,7,0,0,0,0,0,0,1
0,0,0,0,0,6,9,0,0,0,0,0,1,0,0,0,0,0,0,1
0,0,0,0,6,9,0,0,0,0,0,0,1,0,0,0,0,0,0,1
0,0,0,6,9,0,0,0,0,0,0,0,1,0,0,0,0,0,0,1
0,11,1,9,0,0,0,0,0,0,0,0,8,1,1,1,1,1,1,9
