0,0,0,0,0,0,0,0,0,0,0,0,0,0,0,0,0,0,0,0
0,0,0,1,1,1,1,0,0,0,0,0,0,0,0,0,0,0,0,0
0,0,0,1,1,1,1,0,0,0,0,0,0,0,0,0,0,0,0,0
0,0,0,1,1,1,1,0,0,0,0,0,0,0,6,1,1,1,1,0
0,0,0,1,1,1,1,0,0,0,0,0,0,0,1,1,1,1,1,0
0,0,0,0,1,1,1,0,0,0,0,0,0,0,1,1,1,1,1,0
0,0,0,1,1,1,1,0,0,0,0,0,0,0,1,1,1,1,1,0
0,0,0,1,1,1,1,0,0,0,0,0,0,0,1,1,1,1,1,0
0,0,0,1,1,1,1,7,1,0,0,0,0,0,1,1,1,1,1,0
0,0,0,0,1,1,1,1,1,1,0,0,0,0,1,1,1,1,1,0
0,0,0,1,1,1,1,9,1,1,0,0,0,0,8,1,1,1,1,0
0,0,0,1,1,1,1,0,0,0,0,0,0,0,0,0,0,0,0,0
0,0,0,1,1,1,0,0,0,0,0,0,0,0,0,0,0,0,0,0
0,0,0,1,1,0,0,0,0,0,0,0,0,0,0,0,0,0,0,0
0,0,0,1,1,1,1,1,1,1,1,1,1,1,1,1,7,0,0,0
0,0,0,1,1,1,1,1,1,1,1,1,1,1,1,1,1,0,0,0
0,0,0,1,8,1,1,1,1,1,1,1,1,1,1,1,9,0,0,0
0,0,0,0,0,0,0,1,1,1,1,1,1,1,1,1,0,0,0,0
